kuumea=kūmea
tiikina=tīkina
whakareerea=whakarērea
tiikina=tīkina
riiria=rīria
whakāro,whakaro=whakaaro
tokōno,tokono=tokoono
taūtuutu,tautuutu=tauutuutu
arāra,arara=araara
haerēre,haerere=haereere
ihīhi,ihihi=ihiihi
pāorōro,pāororo=pāorooro
tauutūtu,tauututu=tauutuutu
manāki,manaki=manaaki
matāra,matara=mataara
kai-mahi=kaimahi

ae=āe
ēhara=ehara
ēngari=engari
hēoi=heoi
Huitānguru=Huitanguru
īngoa=ingoa
kao=kāo
kaati=kāti
kōnei=konei
kona,kōnā=konā
kōrā,kora=korā
kooti=kōti
mē=me
nānā=nāna
nōnā=nōna
pooti=pōti
raanoo=rā anō
roopu,roopuu=rōpū
tāonga=taonga
tāhūhū=tāhuhu
tēna=tēnā
tēra=tērā
tūtuki=tutuki
ūpoko=upoko
waimārie=waimarie
wāhie=wahie
