# deleted postag entries
#-------------------------------------------------------------------------------
# Do not add words here, but report them to languagetool@taaltik.nl
#-------------------------------------------------------------------------------
aam	aam	ZNW:EKV:HET
adviestopic	adviestopic	ZNW:EKV:HET
aha	aha	UNSPECIFIED
amen	aam	ZNW:MRV:DE_
arbeidsplaatje	arbeidsplaat	ZNW:EKV:VRK:HET
ate	ate	ZNW:EKV
autotopic	autotopic	ZNW:EKV:HET
babytopic	babytopic	ZNW:EKV:HET
beleidstopic	beleidstopic	ZNW:EKV:HET
bijas	bijas	ZNW:MRV:DE_
bikkeltopic	bikkeltopic	ZNW:EKV:HET
binnenkort	binnenkort	BNW:STL:ONV
borreltopic	borreltopic	ZNW:EKV:HET
bouwtopic	bouwtopic	ZNW:EKV:HET
bra	bra	ZNW:EKV
brieventopic	brieventopic	ZNW:EKV:HET
buitenspel	buitenspellen	WKW:TGW:1EP
buitenspelden	buitenspellen	WKW:VLT:INF
buitenspellen	buitenspellen	WKW:TGW:INF
buitenspelt	buitenspellen	WKW:TGW:3EP
cafézaal	cafézaal	ZNW:EKV
cakedoos	cakedoos	ZNW:EKV
cameralamp	cameralamp	ZNW:EKV
center	center	ZNW:EKV:HET
clearingen	clearing	ZNW:MRV:DE_
consolebootje	consoleboot	ZNW:EKV:VRK:HET
consoleboten	consoleboot	ZNW:MRV:DE_
crossauto	crossauto	ZNW:EKV
dansband	dansband	ZNW:EKV
debielentopic	debielentopic	ZNW:EKV:HET
det	det	ZNW:EKV
determinatietopic	determinatietopic	ZNW:EKV:HET
discussietopic	discussietopic	ZNW:EKV:HET
doe-het-zelf	doe-het-zelf	ZNW:EKV
doffer	doffer	ZNW:EKV:HET
dwergauto	dwergauto	ZNW:EKV
ede	ede	UNSPECIFIED
enzovoort	enzovoort	UNSPECIFIED
epa	epa	ZNW:EKV
feedbacktopic	feedbacktopic	ZNW:EKV:HET
feesttopic	feesttopic	ZNW:EKV:HET
fietstopic	fietstopic	ZNW:EKV:HET
flut	flut	ZNW:EKV
formica	formica	ZNW:EKV
forumtopic	forumtopic	ZNW:EKV:HET
frustratietopic	frustratietopic	ZNW:EKV:HET
gangenkeuze	gangenkeuze	ZNW:EKV:DE_
geheelplaatje	geheelplaatje	ZNW:EKV:VRK:HET
gehoorsteentjes	gehoorsteentjes	ZNW:MRV:VRK:DE_
geloog	geloog	ZNW:EKV:HET
geruchtentopic	geruchtentopic	ZNW:EKV:HET
glazenstraatje	glazenstraatje	ZNW:EKV:VRK:HET
godverdomme	godverdomme	UNSPECIFIED
grasheuvel	grasheuvel	ZNW:EKV
heldentopic	heldentopic	ZNW:EKV:HET
hierheen	hierheen	UNSPECIFIED
hoofdtopic	hoofdtopic	ZNW:EKV:HET
huidzenuw	huidzenuw	ZNW:EKV
huisvarken	huisvarken	ZNW:EKV
inlap	inlap	ZNW:EKV
inschrijftopic	inschrijftopic	ZNW:EKV:HET
islamtopic	islamtopic	ZNW:EKV:HET
kattentopic	kattentopic	ZNW:EKV:HET
kennismakingstopic	kennismakingstopic	ZNW:EKV:HET
keuzeblok	keuzeblok	ZNW:EKV
keuzetopic	keuzetopic	ZNW:EKV:HET
klaagtopic	klaagtopic	ZNW:EKV:HET
klikslot	klikslot	ZNW:EKV
knuffeltopic	knuffeltopic	ZNW:EKV:HET
koffietopic	koffietopic	ZNW:EKV:HET
kraaktopic	kraaktopic	ZNW:EKV:HET
kroegspel	kroegspel	ZNW:EKV
kunststofpotjes	kunststofpot	ZNW:MRV:VRK:DE_
kwaliteitstopic	kwaliteitstopic	ZNW:EKV:HET
laadkabel	laadkabel	ZNW:EKV
lichtroze	lichtroze	ZNW:EKV
liefdesgrot	liefdesgrot	ZNW:EKV
liefdesgrotje	liefdesgrot	ZNW:EKV:VRK:HET
loodblok	loodblok	ZNW:EKV
maandagtopic	maandagtopic	ZNW:EKV:HET
maandtopic	maandtopic	ZNW:EKV:HET
maiskorrel	maiskorrel	ZNW:EKV
mannentopic	mannentopic	ZNW:EKV:HET
matrixpanel	matrixpanel	ZNW:EKV:HET
modetopic	modetopic	ZNW:EKV:HET
moedermavootje	moedermavo	ZNW:EKV:VRK:HET
monopolietje	monopolie	ZNW:EKV:VRK:HET
monopolietjes	monopolie	ZNW:MRV:VRK:DE_
moordfilm	moordfilm	ZNW:EKV
mosseltopic	mosseltopic	ZNW:EKV:HET
muziektopic	muziektopic	ZNW:EKV:HET
nachttopic	nachttopic	ZNW:EKV:HET
neukster	neukster	ZNW:EKV:DE_
neuksterretje	neukster	ZNW:EKV:VRK:HET
neuksters	neukster	ZNW:MRV:DE_
nieuwstopic	nieuwstopic	ZNW:EKV:HET
onderzoekstopic	onderzoekstopic	ZNW:EKV:HET
openingstopic	openingstopic	ZNW:EKV:HET
ozb	ozb	ZNW:EKV
piemeltopic	piemeltopic	ZNW:EKV:HET
plaatstootje	plaatstootje	ZNW:EKV:VRK:HET
platentopic	platentopic	ZNW:EKV:HET
podiumplaatje	podiumplaat	ZNW:EKV:VRK:HET
podiumplaten	podiumplaat	ZNW:MRV:DE_
poezentopic	poezentopic	ZNW:EKV:HET
polyform	polyform	ZNW:EKV:DE_
praattopic	praattopic	ZNW:EKV:HET
prachttopic	prachttopic	ZNW:EKV:HET
proeftopic	proeftopic	ZNW:EKV:HET
reactietopic	reactietopic	ZNW:EKV:HET
receptentopic	receptentopic	ZNW:EKV:HET
reclametopic	reclametopic	ZNW:EKV:HET
recordtopic	recordtopic	ZNW:EKV:HET
regelstraat	regelstraat	ZNW:EKV
regents	regent	ZNW:MRV:DE_
reisslot	reisslot	ZNW:EKV
rollentopic	rollentopic	ZNW:EKV:HET
rommeltopic	rommeltopic	ZNW:EKV:HET
schandpaaltopic	schandpaaltopic	ZNW:EKV:HET
schro	schro	ZNW:EKV
schrootje	schro	ZNW:EKV:VRK:HET
sfeertopic	sfeertopic	ZNW:EKV:HET
showdoos	showdoos	ZNW:EKV
showtopic	showtopic	ZNW:EKV:HET
sjorband	sjorband	ZNW:EKV
slijmtopic	slijmtopic	ZNW:EKV:HET
soundbiteje	soundbite	ZNW:EKV:VRK:HET
soundbytes	soundbyte	ZNW:MRV:DE_
spamtopic	spamtopic	ZNW:EKV:HET
speeltopic	speeltopic	ZNW:EKV:HET
sponsortopic	sponsortopic	ZNW:EKV:HET
sporttopic	sporttopic	ZNW:EKV:HET
staalservicecenter	staalservicecenter	ZNW:EKV
starttopic	starttopic	ZNW:EKV:HET
stashen	stashen	ZNW:EKV:DE_
subtopic	subtopic	ZNW:EKV:HET
supertopic	supertopic	ZNW:EKV:HET
tekenclub	tekenclub	ZNW:EKV
testblok	testblok	ZNW:EKV
tietentopic	tietentopic	ZNW:EKV:HET
topic	topic	ZNW:EKV:HET
trouwfilm	trouwfilm	ZNW:EKV
ut	ut	ZNW:EKV
veeleer	veeleer	BNW:STL:ONV
verbouwingstopic	verbouwingstopic	ZNW:EKV:HET
vergadertopic	vergadertopic	ZNW:EKV:HET
verhaaltopic	verhaaltopic	ZNW:EKV:HET
verjaardagstopic	verjaardagstopic	ZNW:EKV:HET
verkiezingstopic	verkiezingstopic	ZNW:EKV:HET
verkooptopic	verkooptopic	ZNW:EKV:HET
verstiet	verstiet	ZNW:EKV:DE_
vervolgtopic	vervolgtopic	ZNW:EKV:HET
verzameltopic	verzameltopic	ZNW:EKV:HET
verzwijn	verzwijn	ZNW:EKV:HET
videotopic	videotopic	ZNW:EKV:HET
viewtopic	viewtopic	ZNW:EKV:HET
vliegtuigtopic	vliegtuigtopic	ZNW:EKV:HET
vlindertopic	vlindertopic	ZNW:EKV:HET
vloektopic	vloektopic	ZNW:EKV:HET
voetbaltopic	voetbaltopic	ZNW:EKV:HET
vof	vof	ZNW:EKV
vogeltopic	vogeltopic	ZNW:EKV:HET
voorsteltopic	voorsteltopic	ZNW:EKV:HET
voortuin	voortuinen	WKW:TGW:1EP
voortuinen	voortuinen	WKW:TGW:INF
voortuint	voortuinen	WKW:TGW:3EP
vragentopic	vragentopic	ZNW:EKV:HET
vrekkentopic	vrekkentopic	ZNW:EKV:HET
vrijdagtopic	vrijdagtopic	ZNW:EKV:HET
vrouwentopic	vrouwentopic	ZNW:EKV:HET
waddenzeecenter	waddenzeecenter	ZNW:EKV
waterballon	waterballon	ZNW:EKV:HET
wedstrijdtopic	wedstrijdtopic	ZNW:EKV:HET
weggeeftopic	weggeeftopic	ZNW:EKV:HET
werkcenter	werkcenter	ZNW:EKV
wijventopic	wijventopic	ZNW:EKV:HET
wink	wink	ZNW:EKV
winterbandentopic	winterbandentopic	ZNW:EKV:HET
wintertopic	wintertopic	ZNW:EKV:HET
zeepblok	zeepblok	ZNW:EKV
zonnecenter	zonnecenter	ZNW:EKV
kunststofpotten	kunststofpot	ZNW:MRV:DE_
veeleerder	veeleer	BNW:VGR:ONV
dl	dl	UNSPECIFIED
EU	EU	ZNW:EKV
HTM	HTM	UNSPECIFIED
enz	enz	UNSPECIFIED
nl	nl	UNSPECIFIED
nr	nr	UNSPECIFIED
kletstopic	kletstopic	ZNW:EKV:HET
ex-kok	ex-kok	ZNW:EKV
uts	ut	ZNW:MRV:DE_
podiumplaat	podiumplaat	ZNW:EKV:DE_
ex-flik	ex-flik	ZNW:EKV
ex-hoer	ex-hoer	ZNW:EKV
mo-akte	mo-akte	ZNW:EKV
kabelstuk	kabelstuk	ZNW:EKV:DE_
kunststofpot	kunststofpot	ZNW:EKV:DE_
besteltopic	besteltopic	ZNW:EKV:HET
megatopic	megatopic	ZNW:EKV:HET
onzintopic	onzintopic	ZNW:EKV:HET
roddeltopic	roddeltopic	ZNW:EKV:HET
voedingstopic	voedingstopic	ZNW:EKV:HET
soundbyte	soundbyte	ZNW:EKV:DE_
ex-heks	ex-heks	ZNW:EKV
botsballon	botsballon	ZNW:EKV
keverslak	keverslak	ZNW:EKV
bloemenpot	bloemenpot	ZNW:EKV
boekslot	boekslot	ZNW:EKV
proefband	proefband	ZNW:EKV
fruitdief	fruitdief	ZNW:EKV
opfokhok	opfokhok	ZNW:EKV
themadoos	themadoos	ZNW:EKV
babybeer	babybeer	ZNW:EKV
fototopic	fototopic	ZNW:EKV:HET
ex-buur	ex-buur	ZNW:EKV
ANW	ANW	UNSPECIFIED
Bos	Bos	UNSPECIFIED
BSN	BSN	UNSPECIFIED
coach-tv	coach-tv	ZNW:EKV
EUR	EUR	UNSPECIFIED
extra's	extra	BNW:STL:VRB
saai	saai	ZNW:EKV:DE_
TNT	TNT	UNSPECIFIED
eken	eken	UNSPECIFIED
garstige	garstige	UNSPECIFIED
ghi	ghi	UNSPECIFIED
kantst	kantst	UNSPECIFIED
limans	limans	UNSPECIFIED
m's	m's	UNSPECIFIED
nagegeten	nagegeten	UNSPECIFIED
r's	r's	UNSPECIFIED
telefoonbotjes	telefoonbotjes	ZNW:MRV:VRK:DE_
koukleumend	koukleumend	ZNW:EKV:HET
splittesten	splittesten	ZNW:MRV:DE_
groentemuseum	groentemuseum	ZNW:EKV:HET
vissersmaatje	vissersmaatje	ZNW:EKV:VRK:HET
shuttlebootjes	shuttlebootjes	ZNW:MRV:VRK:DE_
dievengilden	dievengilden	UNSPECIFIED
shuttleboot	shuttleboot	UNSPECIFIED
projecttopic	projecttopic	ZNW:EKV:HET
gezinsplaatjes	gezinsplaatjes	ZNW:MRV:VRK:DE_
moordfilmpjes	moordfilmpjes	ZNW:MRV:VRK:DE_
stadspraatjes	stadspraatjes	ZNW:MRV:VRK:DE_
splittests	splittests	ZNW:MRV:DE_
communicatiefunctionarissen	communicatiefunctionarissen	ZNW:MRV:DE_
nevelspatje	nevelspatje	ZNW:EKV:VRK:HET
masker-ballon	masker-ballon	ZNW:EKV:DE_
zeiktopic	zeiktopic	ZNW:EKV:HET
infotopic	infotopic	ZNW:EKV:HET
loodblokjes	loodblokjes	ZNW:MRV:VRK:DE_
boekentopic	boekentopic	ZNW:EKV:HET
keuzeblokjes	keuzeblokjes	ZNW:MRV:VRK:DE_
liefdesbootjes	liefdesbootjes	ZNW:MRV:VRK:DE_
stemtopic	stemtopic	ZNW:EKV:HET
genotsgrot	genotsgrot	ZNW:EKV:DE_
luiermatjes	luiermatjes	ZNW:MRV:VRK:DE_
oorlogstopic	oorlogstopic	ZNW:EKV:HET
parkeergaatjes	parkeergaatjes	ZNW:MRV:VRK:DE_
moderatortopic	moderatortopic	ZNW:EKV:HET
jagersboten	jagersboten	ZNW:MRV:DE_
tienergrotjes	tienergrot	ZNW:MRV:VRK:DE_
beginnerstopic	beginnerstopic	ZNW:EKV:HET
kozijnplaatjes	kozijnplaatjes	ZNW:MRV:VRK:DE_
bruidsplaatjes	bruidsplaatjes	ZNW:MRV:VRK:DE_
gezinsmaat	gezinsmaat	UNSPECIFIED
oorlogsmaat	oorlogsmaat	UNSPECIFIED
zevertopic	zevertopic	ZNW:EKV:HET
consolebootjes	consoleboot	ZNW:MRV:VRK:DE_
testtopic	testtopic	ZNW:EKV:HET
kikkerslootje	kikkerslootje	ZNW:EKV:VRK:HET
overzichtstopic	overzichtstopic	ZNW:EKV:HET
racetopic	racetopic	ZNW:EKV:HET
dubbeltopic	dubbeltopic	ZNW:EKV:HET
maiskorreltjes	maiskorreltjes	ZNW:MRV:VRK:DE_
carnavalstopic	carnavalstopic	ZNW:EKV:HET
gezinsmaatje	gezinsmaatje	ZNW:EKV:VRK:HET
juichtopic	juichtopic	ZNW:EKV:HET
dokterspootje	dokterspootje	ZNW:EKV:VRK:HET
gezinsmaatjes	gezinsmaatjes	ZNW:MRV:VRK:DE_
shuttleboten	shuttleboten	ZNW:MRV:DE_
felicitatietopic	felicitatietopic	ZNW:EKV:HET
jagersbootjes	jagersbootjes	ZNW:MRV:VRK:DE_
koelcenter	koelcenter	UNSPECIFIED
hartslotje	hartslotje	ZNW:EKV:VRK:HET
reisslotje	reisslotje	ZNW:EKV:VRK:HET
geschiedenistopic	geschiedenistopic	ZNW:EKV:HET
ex-center	ex-center	UNSPECIFIED
spelletjestopic	spelletjestopic	ZNW:EKV:HET
printklussen	printklussen	ZNW:EKV
janktopic	janktopic	ZNW:EKV:HET
remisegaatjes	remisegaatjes	ZNW:MRV:VRK:DE_
snarenmatjes	snarenmatjes	ZNW:MRV:VRK:DE_
zwangerschapstopic	zwangerschapstopic	ZNW:EKV:HET
pijpenstootje	pijpenstootje	ZNW:EKV:VRK:HET
hoogteplaatjes	hoogteplaatjes	ZNW:MRV:VRK:DE_
sierslot	sierslot	UNSPECIFIED
eroscenter	eroscenter	UNSPECIFIED
sitechecktopic	sitechecktopic	ZNW:EKV:HET
werkplekbeveiligingsbedrijven	werkplekbeveiligingsbedrijven	ZNW:MRV:DE_
geleidevaatje	geleidevaatje	ZNW:EKV:VRK:HET
regisseurstopic	regisseurstopic	ZNW:EKV:HET
meettopic	meettopic	ZNW:EKV:HET
speurneuzentopic	speurneuzentopic	ZNW:EKV:HET
knutseltopic	knutseltopic	ZNW:EKV:HET
modellentopic	modellentopic	ZNW:EKV:HET
gebruikerstopic	gebruikerstopic	ZNW:EKV:HET
paringsmaatje	paringsmaatje	ZNW:EKV:VRK:HET
spoorwegentopic	spoorwegentopic	ZNW:EKV:HET
grasheuveltjes	grasheuveltjes	ZNW:MRV:VRK:DE_
klimaattopic	klimaattopic	ZNW:EKV:HET
verhalentopic	verhalentopic	ZNW:EKV:HET
updatetopic	updatetopic	ZNW:EKV:HET
risicoplaatjes	risicoplaatjes	ZNW:MRV:VRK:DE_
griepstootje	griepstootje	ZNW:EKV:VRK:HET
podiumplaatjes	podiumplaat	ZNW:MRV:VRK:DE_
namentopic	namentopic	ZNW:EKV:HET
hondentopic	hondentopic	ZNW:EKV:HET
slooptopic	slooptopic	ZNW:EKV:HET
jongensboot	jongensboot	UNSPECIFIED
oorlogsmaatje	oorlogsmaatje	ZNW:EKV:VRK:HET
vissersgaatje	vissersgaatje	ZNW:EKV:VRK:HET
verzekeringstopic	verzekeringstopic	ZNW:EKV:HET
zelfbouwtopic	zelfbouwtopic	ZNW:EKV:HET
klapslotje	klapslotje	ZNW:EKV:VRK:HET
jongensnamentopic	jongensnamentopic	ZNW:EKV:HET
ergernissentopic	ergernissentopic	ZNW:EKV:HET
slijkspatje	slijkspatje	ZNW:EKV:VRK:HET
glitterplaatjestopic	glitterplaatjestopic	ZNW:EKV:HET
klapslot	klapslot	UNSPECIFIED
kozijnplaten	kozijnplaten	ZNW:MRV:DE_
kledingtopic	kledingtopic	ZNW:EKV:HET
seniorentopic	seniorentopic	ZNW:EKV:HET
studententopic	studententopic	ZNW:EKV:HET
rokerstopic	rokerstopic	ZNW:EKV:HET
gebedsmaatje	gebedsmaatje	ZNW:EKV:VRK:HET
nabeschouwingstopic	nabeschouwingstopic	ZNW:EKV:HET
liefdestopic	liefdestopic	ZNW:EKV:HET
ochtendtopic	ochtendtopic	ZNW:EKV:HET
vriendjestopic	vriendjestopic	ZNW:EKV:HET
pronkslotje	pronkslotje	ZNW:EKV:VRK:HET
marktplaatstopic	marktplaatstopic	ZNW:EKV:HET
spelerstopic	spelerstopic	ZNW:EKV:HET
zustersmaatje	zustersmaatje	ZNW:EKV:VRK:HET
steuntopic	steuntopic	ZNW:EKV:HET
boekslotje	boekslotje	ZNW:EKV:VRK:HET
schoenentopic	schoenentopic	ZNW:EKV:HET
producttopic	producttopic	ZNW:EKV:HET
gereedschapstopic	gereedschapstopic	ZNW:EKV:HET
uitlegtopic	uitlegtopic	ZNW:EKV:HET
landslootje	landslootje	ZNW:EKV:VRK:HET
verjaardagentopic	verjaardagentopic	ZNW:EKV:HET
klikslotje	klikslotje	ZNW:EKV:VRK:HET
varkensmaatje	varkensmaatje	ZNW:EKV:VRK:HET
broodjesgootje	broodjesgootje	ZNW:EKV:VRK:HET
handelstopic	handelstopic	ZNW:EKV:HET
sierslotje	sierslotje	ZNW:EKV:VRK:HET
beheerderstopic	beheerderstopic	ZNW:EKV:HET
wielrennerstopic	wielrennerstopic	ZNW:EKV:HET
ingenieurstopic	ingenieurstopic	ZNW:EKV:HET
drinkslotje	drinkslotje	ZNW:EKV:VRK:HET
natuurkundetopic	natuurkundetopic	ZNW:EKV:HET
ahs	ahs	ZNW:MRV:DE_
Let	Let	ENM:PER:LST:VDR
Rus	Rus	ENM:PER:LST:NIX
God	God	ENM:PER:LST:NIX
Hun	Hun	ENM:PER:LST:NIX
Lap	Lap	ENM:PER:LST:NIX
Huns	Hun	ENM:BEZ
Laps	Lap	ENM:BEZ
Lets	Let	ENM:BEZ
vertoogjes	vertoog	ZNW:EKV:VRK:HET
verzwijnen	verzwijn	ZNW:MRV:DE_
hoers	hozer	ZNW:MRV:DE_
